NO ./textures/1.xpm
SO ./textures/2.xpm
WE ./textures/3.xpm
EA ./textures/4.xpm
D ./textures/door.xpm

./textures/barrel.xpm 2 8
./textures/barrel.xpm 9 8

C 9,8,14
F 35,38,46

1111111
1E00001
11111D1
   10001
  1000001      111111111111
 100000001     10000000001
100000000011111100000000001
100000000000D00000011111111
10000000001111000001
11111011111  1000001
    101      1000001
    101      1111111
    111
